11111111___W___________________________________________________________________________W___33333333
11111111___W___________________________________________________________________________W___33333333
11111111___W___________________________________________________________________________W___33333333
11111111___W___________________________________________________________________________W___33333333
11111111___W___________________________________________________________________________W___33333333
11111111___W___________________________________________________________________________W___33333333
11111111___W___________________________________________________________________________W___33333333
11111111___W___________________________________________________________________________W___33333333
___________________________________________________________________________________________________
___________________________________________________________________________________________________
___________________________________________________________________________________________________
11111111___W___________________________________________________________________________W___33333333
11111111___W___________________________________________________________________________W___33333333
11111111___W___________________________________________________________________________W___33333333
11111111___W___________________________________________________________________________W___33333333
11111111___W___________________________________________________________________________W___33333333
11111111___W___________________________________________________________________________W___33333333
11111111___W___________________________________________________________________________W___33333333
11111111___W___________________________________________________________________________W___33333333
___________________________________________________________________________________________________
___________________________________________________________________________________________________
___________________________________________________________________________________________________
11111111___W___________________________________________________________________________W___33333333
11111111___W___________________________________________________________________________W___33333333
11111111___W________________________________W__________________________________________W___33333333
11111111___W___________________________________________________________________________W___33333333
11111111___W___________________________________________________________________________W___33333333
11111111___W___________________________________________________________________________W___33333333
11111111___W___________________________________________________________________________W___33333333
11111111___W___________________________________________________________________________W___33333333
___________________________________________________________________________________________________
___________________________________________________________________________________________________
___________________________________________________________________________________________________
11111111___W___________________________________________________________________________W___33333333
11111111___W___________________________________________________________________________W___33333333
11111111___W___________________________________W_______________________________________W___33333333
11111111___W____________________________________W______________________________________W___33333333
11111111___W____________________________________W______________________________________W___33333333
11111111___W_____________________________________W_____________________________________W___33333333
11111111___W_____________________________________W_____________________________________W___33333333
11111111___W___________________________________________________________________________W___33333333
WWWWWWWWWWWW___________________________________________________________________________WWWWWWWWWWWW
___________________________________________________________________________________________________
___________________________________________________________________________________________________
___________________________________________________________________________________________________
___________________________________________________________________________________________________
___________________________________________________________________________________________________
___________________________________________________________________________________________________
___________________________________________________________________________________________________
________________________________________________BB_________________________________________________
________________________________________________BB_________________________________________________
___________________________________________________________________________________________________
___________________________________________________________________________________________________
___________________________________________________________________________________________________
___________________________________________________________________________________________________
___________________________________________________________________________________________________
___________________________________________________________________________________________________
___________________________________________________________________________________________________
WWWWWWWWWWWW___________________________________________________________________________WWWWWWWWWWWW
44444444___W___________________________________________________________________________W___22222222
44444444___W___________________________________________________________________________W___22222222
44444444___W___________________________________________________________________________W___22222222
44444444___W___________________________________________________________________________W___22222222
44444444___W___________________________________________________________________________W___22222222
44444444___W___________________________________________________________________________W___22222222
44444444___W___________________________________________________________________________W___22222222
44444444___W___________________________________________________________________________W___22222222
___________________________________________________________________________________________________
___________________________________________________________________________________________________
___________________________________________________________________________________________________
44444444___W___________________________________________________________________________W___22222222
44444444___W___________________________________________________________________________W___22222222
44444444___W___________________________________________________________________________W___22222222
44444444___W___________________________________________________________________________W___22222222
44444444___W___________________________________________________________________________W___22222222
44444444___W___________________________________________________________________________W___22222222
44444444___W___________________________________________________________________________W___22222222
44444444___W___________________________________________________________________________W___22222222
___________________________________________________________________________________________________
___________________________________________________________________________________________________
___________________________________________________________________________________________________
44444444___W___________________________________________________________________________W___22222222
44444444___W___________________________________________________________________________W___22222222
44444444___W___________________________________________________________________________W___22222222
44444444___W___________________________________________________________________________W___22222222
44444444___W___________________________________________________________________________W___22222222
44444444___W___________________________________________________________________________W___22222222
44444444___W___________________________________________________________________________W___22222222
44444444___W___________________________________________________________________________W___22222222
___________________________________________________________________________________________________
___________________________________________________________________________________________________
___________________________________________________________________________________________________
44444444___W___________________________________________________________________________W___22222222
44444444___W___________________________________________________________________________W___22222222
44444444___W___________________________________________________________________________W___22222222
44444444___W___________________________________________________________________________W___22222222
44444444___W___________________________________________________________________________W___22222222
44444444___W___________________________________________________________________________W___22222222
44444444___W___________________________________________________________________________W___22222222
44444444___W___________________________________________________________________________W___22222222