11111111___W___________________________________________________________________________W___33333333
11111111___W___________________________________________________________________________W___33333333
11111111___W___________________________________________________________________________W___33333333
11111111___W___________________________________________________________________________W___33333333
11111111___W___________________________________________________________________________W___33333333
11111111___W___________________________________________________________________________W___33333333
11111111___W___________________________________________________________________________W___33333333
11111111___W_________________________________________________________W_________________W___33333333
_____________________________________________________________________W_____________________________
_____________________________________________________________________W_____________________________
_____________________________________________________________________W_____________________________
11111111___W___________________________________________________________________________W___33333333
11111111___W__________________________________________________________W________________W___33333333
11111111___W_________________________________________________________W_________________W___33333333
11111111___W________________________________W_______________________W__________________W___33333333
11111111___W________________________________W______________________W___________________W___33333333
11111111___W________________________________W_____________________W____________________W___33333333
11111111___W________________________________W__________________________________________W___33333333
11111111___W___________________________________________________________________________W___33333333
___________________________________________________________________________________________________
____________________________________________W________________WWWW__________________________________
____________________________________________W______________________________________________________
11111111___W________________________________W__________________________________________W___33333333
11111111___W________________________________W__________________________________________W___33333333
11111111___W________________________________W_______________O__________________________W___33333333
11111111___W________________________________W__________________________________________W___33333333
11111111___W________________________________W__________________________________________W___33333333
11111111___W________________________________W__________________________________________W___33333333
11111111___W________________________________W__________________________________________W___33333333
11111111___W___________________________________________________________________________W___33333333
___________________________________________________________________________________________________
___________________________________________________________________________________________________
__________________________________________WW_______________________________________________________
11111111___W________________________________WW_________________________________________W___33333333
11111111___W__________________________________W________________________________________W___33333333
11111111___W___________________________________W_______________________________________W___33333333
11111111___W____________________________________W______________________________________W___33333333
11111111___W____________________________________W______________________________________W___33333333
11111111___W_____________________________________W_____________________________________W___33333333
11111111___W_____________________________________W_____________________________________W___33333333
11111111___W___________________________________________________________________________W___33333333
WWWWWWWWWWWW___________________________________________________________________________WWWWWWWWWWWW
___________________________________________________________________________________________________
___________________________________________________________________________________________________
___________________________________________________________________________________________________
___________________________________________________________________________________________________
___________________________________________________________________________________________________
___________________________________________________________________________________________________
___________________________________________________________________________________________________
________________________________________________BB_________________________________________________
________________________________________________BB_________________________________________________
___________________________________________________________________________________________________
___________________________________________________________________________________________________
___________________________________________________________________________________________________
___________________________________________________________________________________________________
___________________________________________________________________________________________________
___________________________________________________________________________________________________
___________________________________________________________________________________________________
WWWWWWWWWWWW___________________________________________________________________________WWWWWWWWWWWW
44444444___W___________________________________________________________________________W___22222222
44444444___W___________________________________________________________________________W___22222222
44444444___W___________________________________________________________________________W___22222222
44444444___W___________________________________________________________________________W___22222222
44444444___W___________________________________________________________________________W___22222222
44444444___W___________________________________________________________________________W___22222222
44444444___W___________________________________________________________________________W___22222222
44444444___W___________________________________________________________________________W___22222222
___________________________________________________________________________________________________
___________________________________________________________________________________________________
___________________________________________________________________________________________________
44444444___W___________________________________________________________________________W___22222222
44444444___W___________________________________________________________________________W___22222222
44444444___W___________________________________________________________________________W___22222222
44444444___W___________________________________________________________________________W___22222222
44444444___W___________________________________________________________________________W___22222222
44444444___W___________________________________________________________________________W___22222222
44444444___W___________________________________________________________________________W___22222222
44444444___W___________________________________________________________________________W___22222222
___________________________________________________________________________________________________
___________________________________________________________________________________________________
___________________________________________________________________________________________________
44444444___W___________________________________________________________________________W___22222222
44444444___W___________________________________________________________________________W___22222222
44444444___W___________________________________________________________________________W___22222222
44444444___W___________________________________________________________________________W___22222222
44444444___W___________________________________________________________________________W___22222222
44444444___W___________________________________________________________________________W___22222222
44444444___W___________________________________________________________________________W___22222222
44444444___W___________________________________________________________________________W___22222222
___________________________________________________________________________________________________
___________________________________________________________________________________________________
___________________________________________________________________________________________________
44444444___W___________________________________________________________________________W___22222222
44444444___W___________________________________________________________________________W___22222222
44444444___W___________________________________________________________________________W___22222222
44444444___W___________________________________________________________________________W___22222222
44444444___W___________________________________________________________________________W___22222222
44444444___W___________________________________________________________________________W___22222222
44444444___W___________________________________________________________________________W___22222222
44444444___W___________________________________________________________________________W___22222222