{
    "text": [
        "11111111___W_______________________________________D___________________________________W___33333333",
        "11111111___W___________________________________________________________________________W___33333333",
        "11111111___W_____________________W_____________________________O_______________________W___33333333",
        "11111111___W___________D_________W_____________________________________________________W___33333333",
        "11111111___W_____________________W_____N_________O_____________________________________W___33333333",
        "11111111___W_____________________W_____________________________________________________W___33333333",
        "11111111___W_____________________WWWWWWWWW_____________________________________________W___33333333",
        "11111111___W_________________________________________________________W_________________W___33333333",
        "_____________________________________________________________________W_____________________________",
        "______________________D_________________________________D____________W___________D_________________",
        "____________________________________________O________________________W_____________________________",
        "11111111___W_________________________________________________________O_________________W___33333333",
        "11111111___W__________________________________________________________W________________W___33333333",
        "11111111___W_________________________________________________________W_________________W___33333333",
        "11111111___W______________O_________________W___________O___________W__________________W___33333333",
        "11111111___W________________________________W______________________W___________________W___33333333",
        "11111111___W________________________________W_____________________W____________________W___33333333",
        "11111111___W________________________________W__________________________________________W___33333333",
        "11111111___W___________________________________________________________________________W___33333333",
        "___________________________________________________________________________________________________",
        "________________________________D___________W________________WWWW__________________________________",
        "____________________________________________W______________________________________________________",
        "11111111___W________________________________W__________________________________________W___33333333",
        "11111111___W________________________________W____________________________D_____________W___33333333",
        "11111111___W________________________________W_______________O__________________________W___33333333",
        "11111111___W_______________O________________W__________________________________________W___33333333",
        "11111111___W________________________________W__________________________________________W___33333333",
        "11111111___W________________________________W__________________________________________W___33333333",
        "11111111___W________________________________W__________________________________________W___33333333",
        "11111111___W________D__________________________________________________________________W___33333333",
        "____________________________________________________________________O______________________________",
        "___________________________________________________________________________________________________",
        "__________________________________________WW_______________________________________________________",
        "11111111___W________________________________WW_________________________________________W___33333333",
        "11111111___W__________________________________W________________________________________W___33333333",
        "11111111___W_____________O_____________________W_______________________________________W___33333333",
        "11111111___W____________________________________W______________________________________W___33333333",
        "11111111___W____________________________________W______________________________________W___33333333",
        "11111111___W_____________________________________W_____________________________________W___33333333",
        "11111111___W_____________D_______________________W_____________________________________W___33333333",
        "11111111___W___________________________________________________________________________W___33333333",
        "WWWWWWWWWWWW____________________________O______________________________________________WWWWWWWWWWWW",
        "___________________________________________________________________________________________________",
        "_______________________________________________________________________W___________________________",
        "_____________________________________________________________WWWWWWWWWWW___________________________",
        "______________________W______________________________________W_________W___________________________",
        "_____________________W_______________________________________W____N____WWWWWWW_____________________",
        "____________________W________________________________________W_________W___________________________",
        "______D____________W_________________________________________W_________W___________________________",
        "__________________W____________D________________BB_____________________W___________________________",
        "_________________W______________________________BB_____________________W___________________________",
        "________________W__________________________________________________________________________________",
        "________________W__________________________________________________________________________________",
        "________________W__________________________________________________________________________________",
        "________________W____________________________________________W_____________________________________",
        "_____________________________________________________________W_____________________________________",
        "_____________________________D____________________D__________W_____________________________________",
        "_____________________________________________________________W_____________________________________",
        "WWWWWWWWWWWW_________________________________________________W_________________________WWWWWWWWWWWW",
        "44444444___W________________________________________________W__________________________W___22222222",
        "44444444___W_______________________________________________W___________D_______________W___22222222",
        "44444444___W______________________________________________W____________________________W___22222222",
        "44444444___W__________________________________________WWWW_____________________________W___22222222",
        "44444444___W____________________D______________________________________________________W___22222222",
        "44444444___W___________________________________________________________________________W___22222222",
        "44444444___W___________________________________________________________________________W___22222222",
        "44444444___W___________________________________________________________________________W___22222222",
        "___________________________________________________________________________________________________",
        "____________________________________W______________________________________________________________",
        "_____________________________________W_____________________________________________________________",
        "44444444___W__________________________W________________________________________________W___22222222",
        "44444444___W___________________________W________D______________________________________W___22222222",
        "44444444___W____________________________W______________________________________________W___22222222",
        "44444444___W_____________________________W_____________________________________________W___22222222",
        "44444444___W_____________________________W_______________________W_____________________W___22222222",
        "44444444___W_____________________________W_______________________W_____________________W___22222222",
        "44444444___W_____________________________W_______________________W_____________________W___22222222",
        "44444444___W_____________________________W______________________W______________________W___22222222",
        "______________________D__________________WWWWWWWW_______________W_______D__________________________",
        "________________________________________________________________W__________________________________",
        "_______________________________________________________________W___________________________________",
        "44444444___W___________________________________________________W_______________________W___22222222",
        "44444444___W___________________________________________________W_______________________W___22222222",
        "44444444___W_______________________W__________________________W________________________W___22222222",
        "44444444___W_______________________W___________________________________________________W___22222222",
        "44444444___W_______________________W_______________________O___________________________W___22222222",
        "44444444___W_______________________WWWWWW______________________________________________W___22222222",
        "44444444___W______________________W_________________________O__________________________W___22222222",
        "44444444___W_____________________W__________________________W__________________________W___22222222",
        "________________________________W__________________________W______________D________________________",
        "_______________________________W__________________________W________________________________________",
        "______________________________W__________________________W_________________________________________",
        "44444444___W__________________________D_________________W______________________________W___22222222",
        "44444444___W___________________________________________W_______________________________W___22222222",
        "44444444___W___________________________________________W_______________________________W___22222222",
        "44444444___W___________________________________________W_______________________________W___22222222",
        "44444444___W________________D__________________________W_______________________________W___22222222",
        "44444444___W_________________D_________________________W_________________D_____________W___22222222",
        "44444444___W___________________________________________________________________________W___22222222",
        "44444444___W___________________________________________________________________________W___22222222"
    ]
}