{
    "text": [
        "1________4",
        "1________4",
        "1_O______4",
        "1___W__O_4",
        "1___W____4",
        "WWW_W__WWW",
        "3O__W____2",
        "3___W_O__2",
        "3________2",
        "3________2"
    ]
}